##########*.###########*#############.###
##..#.......*.#*...#....#.......#.....#.#
#.***.###.#...#.#*###**##.*.*.#.*####.*.#
##.........#*.*.....#..*#...*.....*#..*.#
.###***.*...*##*#####.*.#**.*.*##.#.#**.#
#...*...*.#.*.....*...#.*...#...*.*.#...#
#.*.*##*#.***.###*#..##.*.#**##**..#.#*.*
#.*..#....#.*.#.*...#...#*.......##.#...#
#.####*.#**##**.*.*#*###*.###.#..*#.#**.#
#.*...............*...#.....*.....#...**#
#.###**.**.#*##**.#.**#***#.##**.##*#.###
#...#.#.*..#....#.*.......#.#...#...*.*.#
#.*.**#*#*#.#**.#.***.#*#.#**.*.*#*#*##.#
#.**..#......##...#.*.#.#.....*.*.....#.*
#.*##**.*.#***#.**#**.#**#*#.**.*#*.##..#
#.*..#..#.#...#.#.....*......##..##.#.#.#
*.*.*#*##.#...*.*...**#.*.#*..#.#.#**.#..
#.#.#...#.#.#.*...#.*...#..**...*.....#.#
#.*.#.*.#.#.#.**##*.*.###.#..*#*.*.#*##.#
#.#*..#.#.#.#.....*.#..#.*.#..#*....*...#
#.*#.**#..#*##*#*...***.#.#*#.#*#.*.**#*#
#.....#.*.*.#.....#...#.*.#...*...*.*...#
#.*#*#.*###.*.*#*****.#.#**.#.*.#*.**.#.#
#..*....*..*#.....#.*.#...*.#.##*.......#
#.***.#**.*.*#***.***.***.*.###.#.##*.#*#
#...*...#.#.#.*...#*..*...#.*.#.#....*#.#
#*#.#.#.###.*.#.###**#*...#.#.*.**..#.*.#
#...#.#...*..*#.......*##...*.*..**.##.*#
.#..#*#..##*##*##***#.#.#.*##.#.*.#.#*#.#
*.#...#.#*..............*.*..#*.*.....*.#
#.###.#...*#*#*.#**.*****.#.#*#**####**.#
#...#.*.......*.#.*...**..#...#.*...*....
##*#*.#*.*###...#.***.##****#.#.*.#.*.*##
#*....#...*...*.#...#.....#.*.#...#*..#.#
#.**.**.*.*..*#.*.*.*.*##**.*.**###**##.#
#.#.....*.#...#.#.#.*......##..#..*....*#
#.**#.*#*.#.**..#.*.*.#.###**..*#.#.*.#..
#...#.*...#.*.....##*.........*.*....####
#*..#...#*#.*..**.*..*#*##*.*.#*.*##..#..
......#.*.**..#*...*.....#.##.*....#....#
#########.#.##############.#..######*.###

